53
25
XXXXXXXXXXXXXXXXXXXXXXXXXXXXXXXXXXXXXXXXXXXXXXXXXXXXX
X-1-X-E---------------------------------------------X
X---XXXXXXXXXXXXXXXXXXXXXXXXXXXXXXXXXXXXXXXXXXXXXX--X
X------------------------------------------------X--X
X---XXXXXXXXXXXXXXXXXXXXXXXXXXXXXXXXXXXXXXX-XXXXXX--X
X---X--------------------------------------------X--X
X---X--------------------------------------------X--X
X---X--------------------------------------------X--X
X---X--------------------------------------------X--X
X---X--XXXXXXXXXXXXXXXXXXXXXXXXXXXXXXXXXXXXXXXXXXX--X
X---X------------------------X---X--X-----X---------X
X---X--XXXXXXXXXXXXXXXXXXXXXXX---X-----X-----X--XXXXX
X---X-----------X------------X---XXXXXXXXXXXXXX-X---X
X---X------X----X-----X------X---X--------------X---X
X---X------X----XXXXXXXXXXX--X---X-XXXXXXXXXXXXXX---X
X---X------X-----------------X---X--------------x---X
X---X------X----XXXXXXXXXXXXXX---XXXXX----------X---X
X---X------X-----------------X---c---X----------X---X
X---X------X-----------------X---XXX-X---XXXXXXXX---X
X---X------XXXXXXXXXXXXXXXXXXX---X-X-X--------------X
X---X------------------------X---X-X-X--XXXXXXXXXXXXX
X---X------------------------X---X-X-X--------------X
X---XXXXXXXXXXXXXXXXXXXXXXX--X---X-X-XXXXXXXXXXXX---X
X---X----------------------------X------------------X
XXXXXXXXXXXXXXXXXXXXXXXXXXXXXXXXXXXXXXXXXXXXXXXXXXXXX